누적확진률,누적검사,누적검사완료,치료중,격리해제,사망자,확진자,검사진행,음성,기준일,기준날짜,년,월,일,전날대비확진자,확진자증감,확진s,로그
5.557314756,109591,75792,,31,22,4212,33799,71580,20200302,2020-03-02,2020,3,2,4212,4212,100,3.624488363
5.329139718,125851,90296,4159,34,28,4812,35555,85484,20200303,2020-03-03,2020,3,3,600,-3612,14.24501425,3.682325619
4.919985595,136707,108293,4750,41,32,5328,28414,102965,20200304,2020-03-04,2020,3,4,516,-84,10.72319202,3.726564216
4.622748154,146541,124731,5255,88,35,5766,21810,118965,20200305,2020-03-05,2020,3,5,438,-78,8.220720721,3.760874638
4.397234584,164740,142908,5643,108,42,6284,21832,136624,20200306,2020-03-06,2020,3,6,518,80,8.983697537,3.798236176
4.267542836,178189,158569,6134,118,44,6767,19620,151802,20200307,2020-03-07,2020,3,7,483,-35,7.686187142,3.830396176
4.21775786,188518,169142,6605,130,50,7134,19376,162008,20200308,2020-03-08,2020,3,8,367,-116,5.423378159,3.853333105
4.120339361,196618,179160,6954,166,51,7382,17458,171778,20200309,2020-03-09,2020,3,9,248,-119,3.476310625,3.868174041
3.919308057,210144,191692,7165,247,54,7513,18452,184179,20200310,2020-03-10,2020,3,10,131,-117,1.774586833,3.875813389
3.804174536,222395,203855,7212,288,60,7755,18540,196100,20200311,2020-03-11,2020,3,11,242,111,3.221083455,3.889581802
3.621744273,234998,217271,7407,333,66,7869,17727,209402,20200312,2020-03-12,2020,3,12,114,-128,1.470019342,3.895919545
3.458499309,248647,230707,7470,510,67,7979,17940,222728,20200313,2020-03-13,2020,3,13,110,-4,1.397890456,3.901948465
3.318000336,261335,243701,7402,714,72,8086,17634,235615,20200314,2020-03-14,2020,3,14,107,-3,1.341020178,3.907733737
3.239660237,268212,251940,7300,834,75,8162,16272,243778,20200315,2020-03-15,2020,3,15,76,-31,0.939896117,3.91179659
3.173392208,274504,259533,7253,1137,75,8236,14971,251297,20200316,2020-03-16,2020,3,16,74,-2,0.906640529,3.915716338
3.088057901,286716,269425,7024,1401,81,8320,17291,261105,20200317,2020-03-17,2020,3,17,84,10,1.019912579,3.920123326
3.012162506,295647,279301,6838,1540,84,8413,16346,270888,20200318,2020-03-18,2020,3,18,93,9,1.117788462,3.924950889
2.942085738,307024,291120,6789,1947,91,8565,15904,282555,20200319,2020-03-19,2020,3,19,152,59,1.806727683,3.932727367
2.873091828,316664,301139,6527,2233,94,8652,15525,292487,20200320,2020-03-20,2020,3,20,87,-65,1.015761821,3.937116511
2.82195603,327509,311805,6325,2612,102,8799,15704,303006,20200321,2020-03-21,2020,3,21,147,60,1.699029126,3.944433318
2.804501324,331780,317240,6085,2909,104,8897,14540,308343,20200322,2020-03-22,2020,3,22,98,-49,1.113762928,3.949243591
2.762262336,338036,324408,5884,3166,111,8961,13628,315447,20200323,2020-03-23,2020,3,23,64,-34,0.719343599,3.952356477
2.712657065,348582,333142,5684,3507,120,9037,15440,324105,20200324,2020-03-24,2020,3,24,76,12,0.84811963,3.956024282
2.659057442,357896,343618,5410,3730,126,9137,14278,334481,20200325,2020-03-25,2020,3,25,100,24,1.106561912,3.960803625
2.635970254,364942,350573,5281,4144,131,9241,14369,341332,20200326,2020-03-26,2020,3,26,104,4,1.138229178,3.96571897
2.579739151,376961,361742,4966,4528,139,9332,15219,352410,20200327,2020-03-27,2020,3,27,91,-13,0.984741911,3.96997473
2.552233541,387925,371361,4665,4811,144,9478,16564,361883,20200328,2020-03-28,2020,3,28,146,55,1.564509216,3.976716704
2.527742388,394141,379113,4523,5033,152,9583,15028,369530,20200329,2020-03-29,2020,3,29,105,-41,1.107828656,3.981501488
2.531290694,395194,381663,4398,5228,158,9661,13531,372002,20200330,2020-03-30,2020,3,30,78,-27,0.813941354,3.985022082
2.485825764,410564,393672,4275,5408,162,9786,16892,383886,20200331,2020-03-31,2020,3,31,125,47,1.293861919,3.990605211
2.441463644,421547,404962,4216,5567,165,9887,16585,395075,20200401,2020-04-01,2020,4,1,101,-24,1.032086654,3.995064534
2.410488622,431743,413858,4155,5828,169,9976,17885,403882,20200402,2020-04-02,2020,4,2,89,-12,0.900171943,3.99895644
2.371072072,443273,424365,3979,6021,174,10062,18908,414303,20200403,2020-04-03,2020,4,3,86,-3,0.862068966,4.002684313
2.33531392,455032,434888,3867,6325,177,10156,20144,424732,20200404,2020-04-04,2020,4,4,94,8,0.934207911,4.006722692
2.317835811,461233,441662,3654,6463,183,10237,19571,431425,20200405,2020-04-05,2020,4,5,81,-13,0.797558094,4.010172703
2.298054341,466804,447509,3591,6598,186,10284,19295,437225,20200406,2020-04-06,2020,4,6,47,-34,0.459118882,4.012162068
2.262325524,477304,456654,3500,6694,192,10331,20650,446323,20200407,2020-04-07,2020,4,7,47,0,0.457020615,4.014142362
2.218116182,486003,468145,3445,6776,200,10384,17858,457761,20200408,2020-04-08,2020,4,8,53,6,0.513019069,4.016364679
2.175074395,494711,479202,3408,6973,204,10423,15509,468779,20200409,2020-04-09,2020,4,9,39,-14,0.375577812,4.017992738
2.142477853,503051,487753,3246,7117,208,10450,15298,477303,20200410,2020-04-10,2020,4,10,27,-12,0.259042502,4.01911629
2.111162368,510479,496409,3125,7243,211,10480,14070,485929,20200411,2020-04-11,2020,4,11,30,3,0.28708134,4.020361283
2.098903227,514621,500833,3026,7368,214,10512,13788,490321,20200412,2020-04-12,2020,4,12,32,2,0.305343511,4.021685352
2.08508129,518743,505352,2930,7447,217,10537,13391,494815,20200413,2020-04-13,2020,4,13,25,-7,0.23782344,4.02271698
2.060114628,527438,512787,2873,7534,222,10564,14651,502223,20200414,2020-04-14,2020,4,14,27,2,0.256239916,4.023828393
2.038589022,534552,519526,2808,7616,225,10591,15026,508935,20200415,2020-04-15,2020,4,15,27,0,0.255585006,4.024936968
2.023423901,538775,524507,2750,7757,229,10613,14268,513894,20200416,2020-04-16,2020,4,16,22,-5,0.207723539,4.025838164
1.998019828,546463,532277,2627,7829,230,10635,14186,521642,20200417,2020-04-17,2020,4,17,22,0,0.207292943,4.026737494
1.968098078,554834,541284,2576,7937,232,10653,13550,530631,20200418,2020-04-18,2020,4,18,18,-4,0.169252468,4.027471927
1.949472083,559109,546866,2484,8042,234,10661,12243,536205,20200419,2020-04-19,2020,4,19,8,-10,0.075096217,4.027797943
1.937015247,563035,551054,2385,8114,236,10674,11981,540380,20200420,2020-04-20,2020,4,20,13,5,0.121939781,4.028327198
1.913511364,571014,558293,2324,8213,237,10683,12721,547610,20200421,2020-04-21,2020,4,21,9,-4,0.084317032,4.028693228
1.88994023,577959,565838,2233,8277,238,10694,12121,555144,20200422,2020-04-22,2020,4,22,11,2,0.102967331,4.02914018
1.865005786,583971,573832,2179,8411,240,10702,10139,563130,20200423,2020-04-23,2020,4,23,8,-3,0.074808304,4.029464947
1.846461581,589520,579920,2051,8501,240,10708,9600,569212,20200424,2020-04-24,2020,4,24,6,-2,0.056064287,4.029708363
1.829316166,595161,585902,1967,8635,240,10718,9259,575184,20200425,2020-04-25,2020,4,25,10,4,0.093388121,4.030113753
1.820508208,598285,589286,1843,8717,242,10728,8999,578558,20200426,2020-04-26,2020,4,26,10,0,0.093300989,4.030518765
1.811510464,601660,592765,1769,8764,243,10738,8895,582027,20200427,2020-04-27,2020,4,27,10,0,0.093214019,4.0309234
1.794060179,608514,599311,1731,8854,244,10752,9203,588559,20200428,2020-04-28,2020,4,28,14,4,0.130378096,4.031489256
1.776064962,614197,605890,1654,8922,246,10761,8307,595129,20200429,2020-04-29,2020,4,29,9,-5,0.083705357,4.031852631
1.761153838,619881,611247,1593,9059,247,10765,8634,600482,20200430,2020-04-30,2020,4,30,4,-5,0.037171267,4.032014034
1.753626397,623069,614384,1459,9072,248,10774,8685,603610,20200501,2020-05-01,2020,5,1,9,5,0.083604273,4.032376971
1.741332911,627562,619066,1454,9123,250,10780,8496,608286,20200502,2020-05-02,2020,5,2,6,-3,0.055689623,4.032618761
1.734135623,630973,622385,1407,9183,250,10793,8588,611592,20200503,2020-05-03,2020,5,3,13,7,0.120593692,4.033142177
1.726102486,633921,625745,1360,9217,252,10801,8176,614944,20200504,2020-05-04,2020,5,4,8,-5,0.074122116,4.033463966
1.711175063,640237,631379,1332,9283,254,10804,8858,620575,20200505,2020-05-05,2020,5,5,3,-5,0.027775206,4.033584576
1.701501844,643095,635086,1267,9333,255,10806,8009,624280,20200506,2020-05-06,2020,5,6,2,-1,0.018511662,4.033664963
1.686535332,649388,640959,1218,9419,256,10810,8429,630149,20200507,2020-05-07,2020,5,7,4,2,0.037016472,4.033825694
1.675242571,654863,645996,1135,9484,256,10822,8867,635174,20200508,2020-05-08,2020,5,8,12,8,0.111008326,4.03430753
1.665445238,660030,650877,1082,9568,256,10840,9153,640037,20200509,2020-05-09,2020,5,9,18,6,0.166327851,4.035029282
1.663306606,663886,653758,1016,9610,256,10874,10128,642884,20200510,2020-05-10,2020,5,10,34,16,0.313653137,4.036389329
1.658986876,668492,657570,1008,9632,256,10909,10922,646661,20200511,2020-05-11,2020,5,11,35,1,0.321868678,4.037784942
1.645600096,680890,664560,1021,9670,258,10936,16330,653624,20200512,2020-05-12,2020,5,12,27,-8,0.247502063,4.038858502
1.62078005,695920,676341,1008,9695,259,10962,19579,665379,20200513,2020-05-13,2020,5,13,26,-1,0.237746891,4.039889798
1.591141377,711484,690762,1008,9762,260,10991,20722,679771,20200514,2020-05-14,2020,5,14,29,3,0.264550265,4.041037208
1.558698039,726747,706872,969,9821,260,11018,19875,695854,20200515,2020-05-15,2020,5,15,27,-2,0.245655536,4.042102768
1.528031211,740645,722302,937,9851,262,11037,18343,711265,20200516,2020-05-16,2020,5,16,19,-8,0.17244509,4.042851043
1.513713145,747653,729993,924,9888,262,11050,17660,718943,20200517,2020-05-17,2020,5,17,13,-6,0.11778563,4.043362278
1.501116511,753211,737118,900,9904,263,11065,16093,726053,20200518,2020-05-18,2020,5,18,15,2,0.135746606,4.043951418
1.479732158,765574,748649,898,9938,263,11078,16925,737571,20200519,2020-05-19,2020,5,19,13,-2,0.117487573,4.044461361
1.461684397,776433,760082,877,10066,263,11110,16351,748972,20200520,2020-05-20,2020,5,20,32,19,0.288860805,4.045714059
1.443300307,788684,770595,781,10135,264,11122,18089,759473,20200521,2020-05-21,2020,5,21,12,-20,0.108010801,4.046182891
1.42456772,802418,782132,723,10162,264,11142,20286,770990,20200522,2020-05-22,2020,5,22,20,8,0.179823773,4.046963154
1.408209109,814420,792851,716,10194,266,11165,21569,781686,20200523,2020-05-23,2020,5,23,23,3,0.206426135,4.047858727
1.398826935,820289,799956,705,10213,266,11190,20333,788766,20200524,2020-05-24,2020,5,24,25,2,0.223914017,4.048830087
1.388001209,826437,807348,711,10226,267,11206,19089,796142,20200525,2020-05-25,2020,5,25,16,-9,0.142984808,4.049450618
1.373204589,839475,817431,713,10275,269,11225,22044,806206,20200526,2020-05-26,2020,5,26,19,3,0.169552026,4.05018635
1.354267475,852876,831815,681,10295,269,11265,21061,820550,20200527,2020-05-27,2020,5,27,40,21,0.356347439,4.051731196
1.340429353,868666,846296,701,10340,269,11344,22370,834952,20200528,2020-05-28,2020,5,28,79,39,0.701287173,4.054766218
1.324946576,885120,860563,735,10363,269,11402,24557,849161,20200529,2020-05-29,2020,5,29,58,-21,0.511283498,4.056981037
1.305151819,902901,876603,770,10398,269,11441,26298,865162,20200530,2020-05-30,2020,5,30,39,-19,0.342045255,4.058463986
1.292128248,910822,887528,774,10405,270,11468,23294,876060,20200531,2020-05-31,2020,5,31,27,-12,0.235993357,4.059487684
1.281909837,921391,897333,793,10422,271,11503,24058,885830,20200601,2020-06-01,2020,6,1,35,8,0.30519707,4.06081112
1.266948357,939851,910929,810,10446,272,11541,28922,899388,20200602,2020-06-02,2020,6,2,38,3,0.330348605,4.062243441
1.247595499,956852,928987,823,10467,273,11590,27865,917397,20200603,2020-06-03,2020,6,3,49,11,0.424573261,4.064083436
1.229724457,973858,945659,850,10499,273,11629,28199,934030,20200604,2020-06-04,2020,6,4,39,-10,0.33649698,4.065542371
1.212645267,990960,962194,857,10506,273,11668,28766,950526,20200605,2020-06-05,2020,6,5,39,0,0.335368475,4.06699642
1.199057452,1005305,977351,889,10531,273,11719,27954,965632,20200606,2020-06-06,2020,6,6,51,12,0.437092904,4.068890554
1.193971741,1012769,986288,915,10552,273,11776,26481,974512,20200607,2020-06-07,2020,6,7,57,6,0.486389624,4.070997797
1.188623107,1018213,993839,951,10563,273,11813,24374,982026,20200608,2020-06-08,2020,6,8,37,-20,0.31419837,4.072360204
1.175068441,1035996,1008537,977,10589,274,11851,27459,996686,20200609,2020-06-09,2020,6,9,38,1,0.321679506,4.073754998
1.160226488,1051971,1025748,988,10611,276,11901,26223,1013847,20200610,2020-06-10,2020,6,10,50,12,0.421905324,4.075583455
1.147117371,1066887,1041393,1014,10654,276,11946,25494,1029447,20200611,2020-06-11,2020,6,11,45,-5,0.378119486,4.07722251
1.135217859,1081486,1057242,1016,10669,277,12002,24244,1045240,20200612,2020-06-12,2020,6,12,56,11,0.468776159,4.079253622
1.124748098,1094703,1071351,1056,10691,277,12050,23352,1059301,20200613,2020-06-13,2020,6,13,48,-8,0.399933344,4.080987047
1.119955958,1100327,1078971,1082,10718,277,12084,21356,1066887,20200614,2020-06-14,2020,6,14,34,-14,0.282157676,4.082210717
1.117219055,1105719,1084926,1089,10730,277,12121,20793,1072805,20200615,2020-06-15,2020,6,15,37,3,0.306190003,4.083538451
1.107885538,1119767,1097135,1114,10760,278,12155,22632,1084980,20200616,2020-06-16,2020,6,16,34,-3,0.280504909,4.084754963
1.097599821,1132823,1111334,1117,10774,279,12198,21489,1099136,20200617,2020-06-17,2020,6,17,43,9,0.353763883,4.086288629
1.090482367,1145712,1123998,1145,10800,280,12257,21714,1111741,20200618,2020-06-18,2020,6,18,59,16,0.48368585,4.088384186
1.082442806,1158063,1136873,1177,10835,280,12306,21190,1124567,20200619,2020-06-19,2020,6,19,49,-10,0.399771559,4.090116911
1.07644565,1170901,1149431,1191,10856,280,12373,21470,1137058,20200620,2020-06-20,2020,6,20,67,18,0.544449862,4.092475013
1.074116736,1176463,1156392,1237,10868,280,12421,20071,1143971,20200621,2020-06-21,2020,6,21,48,-19,0.387941485,4.094156562
1.069785484,1182066,1162663,1273,10881,280,12438,19403,1150225,20200622,2020-06-22,2020,6,22,17,-31,0.136864987,4.094750552
1.063614073,1196012,1173734,1277,10908,281,12484,22278,1161250,20200623,2020-06-23,2020,6,23,46,29,0.369834379,4.09635376
1.05482214,1208597,1188352,1295,10930,281,12535,20245,1175817,20200624,2020-06-24,2020,6,24,51,5,0.408522909,4.098124338
1.045541779,1220478,1201578,1324,10974,282,12563,18900,1189015,20200625,2020-06-25,2020,6,25,28,-23,0.223374551,4.09909336
1.03849485,1232315,1213487,1307,11172,282,12602,18828,1200885,20200626,2020-06-26,2020,6,26,39,11,0.310435406,4.100439475
1.033814467,1243780,1223914,1148,11317,282,12653,19866,1211261,20200627,2020-06-27,2020,6,27,51,12,0.404697667,4.102193508
1.03148399,1251695,1232690,1054,11364,282,12715,19005,1219975,20200628,2020-06-28,2020,6,28,62,11,0.490002371,4.104316365
1.027584568,1259954,1241455,1069,11429,282,12757,18499,1228698,20200629,2020-06-29,2020,6,29,42,-20,0.330318521,4.105748556
1.021504347,1273765,1252956,1046,11537,282,12799,20809,1240157,20200630,2020-06-30,2020,6,30,42,0,0.32923101,4.107176039
1.015244468,1285231,1265705,980,11613,282,12850,19526,1252855,20200701,2020-07-01,2020,7,1,51,9,0.39846863,4.108903128
1.011142629,1295962,1276180,955,11684,282,12904,19782,1263276,20200702,2020-07-02,2020,7,2,54,3,0.420233463,4.110724354
1.008007302,1307761,1286201,938,11759,282,12965,21560,1273236,20200703,2020-07-03,2020,7,3,61,7,0.472721637,4.112772521
1.00431699,1319521,1297200,924,11811,283,13028,22321,1284172,20200704,2020-07-04,2020,7,4,63,2,0.485923641,4.11487775
1.003445246,1326055,1304406,934,11832,283,13089,21649,1291317,20200705,2020-07-05,2020,7,5,61,-2,0.46822229,4.116906468
1.002438756,1331796,1310504,974,11848,284,13137,21292,1297367,20200706,2020-07-06,2020,7,6,48,-13,0.366720147,4.1184962
0.996658649,1346194,1322519,1005,11914,285,13181,23675,1309338,20200707,2020-07-07,2020,7,7,44,-4,0.334931872,4.11994836
0.991448819,1359734,1335722,982,11970,285,13243,24012,1322479,20200708,2020-07-08,2020,7,8,62,18,0.470374023,4.121986379
0.986230756,1371771,1347859,988,12019,287,13293,23912,1334566,20200709,2020-07-09,2020,7,9,50,-12,0.377557955,4.123623005
0.97975338,1384890,1361363,987,12065,288,13338,23527,1348025,20200710,2020-07-10,2020,7,10,45,-5,0.338524035,4.125090713
0.973296041,1396941,1373991,985,12144,288,13373,22950,1360618,20200711,2020-07-11,2020,7,11,35,-10,0.262408157,4.126228845
0.972025206,1402144,1380314,941,12178,289,13417,21830,1366897,20200712,2020-07-12,2020,7,12,44,9,0.329021162,4.12765542
0.972183254,1408312,1386467,950,12204,289,13479,21845,1372988,20200713,2020-07-13,2020,7,13,62,18,0.46210032,4.129657673
0.967681639,1420616,1396327,986,12282,289,13512,24289,1382815,20200714,2020-07-14,2020,7,14,33,-29,0.244825284,4.130719637
0.96241599,1431316,1408019,941,12348,289,13551,23297,1394468,20200715,2020-07-15,2020,7,15,39,6,0.288632327,4.131971345
0.959981494,1441348,1417944,914,12396,291,13612,23404,1404332,20200716,2020-07-16,2020,7,16,61,22,0.45015128,4.13392194
0.957485326,1451017,1427907,925,12460,293,13672,23110,1414235,20200717,2020-07-17,2020,7,17,60,-1,0.44078754,4.13583205
0.953954028,1460204,1437281,919,12519,294,13711,22923,1423570,20200718,2020-07-18,2020,7,18,39,-21,0.285254535,4.137069131
0.952301111,1465299,1443346,898,12556,295,13745,21953,1429601,20200719,2020-07-19,2020,7,19,34,-5,0.247976078,4.138144744
0.950451069,1470193,1448891,894,12572,296,13771,21302,1435120,20200720,2020-07-20,2020,7,20,26,-8,0.189159694,4.138965478
0.947257711,1482390,1458526,903,12643,296,13816,23864,1444710,20200721,2020-07-21,2020,7,21,45,19,0.326773655,4.140382325
0.943944175,1492071,1470320,877,12698,297,13879,21751,1456441,20200722,2020-07-22,2020,7,22,63,18,0.455993052,4.142358176
0.942115779,1500854,1479436,884,12758,297,13938,21418,1465498,20200723,2020-07-23,2020,7,23,59,-4,0.425102673,4.14420046
0.938334022,1510327,1489768,883,12817,298,13979,20559,1475789,20200724,2020-07-24,2020,7,24,41,-18,0.294159851,4.145476105
0.940122872,1518634,1498953,864,12866,298,14092,19681,1484861,20200725,2020-07-25,2020,7,25,113,72,0.80835539,4.148972635
0.94100466,1522926,1503712,928,12890,298,14150,19214,1489562,20200726,2020-07-26,2020,7,26,58,-55,0.411581039,4.15075644
0.939859595,1526974,1508204,962,12905,299,14175,18770,1494029,20200727,2020-07-27,2020,7,27,25,-33,0.176678445,4.151523068
0.93609533,1537704,1517260,971,13007,300,14203,20444,1503057,20200728,2020-07-28,2020,7,28,28,3,0.197530864,4.152380087
0.932668665,1547307,1527981,896,13069,300,14251,19326,1513730,20200729,2020-07-29,2020,7,29,48,20,0.33795677,4.15384534
0.928247973,1556215,1537197,882,13132,300,14269,19018,1522928,20200730,2020-07-30,2020,7,30,18,-30,0.126306926,4.154393538
0.925610787,1563796,1545466,837,13183,301,14305,18330,1531161,20200731,2020-07-31,2020,7,31,36,18,0.252295185,4.155487862
0.922788552,1571830,1553552,821,13233,301,14336,18278,1539216,20200801,2020-08-01,2020,8,1,31,-5,0.216707445,4.156427992
0.921796779,1576246,1558478,802,13259,301,14366,17768,1544112,20200802,2020-08-02,2020,8,2,30,-1,0.209263393,4.157335862
0.920980878,1579757,1562356,806,13280,301,14389,17401,1547967,20200803,2020-08-03,2020,8,3,23,-7,0.160100237,4.158030613
0.918044933,1589780,1571056,808,13352,301,14423,18724,1556633,20200804,2020-08-04,2020,8,4,34,11,0.236291612,4.159055604
0.915112202,1598187,1579697,770,13406,302,14456,18490,1565241,20200805,2020-08-05,2020,8,5,33,-1,0.22880122,4.16004814
0.912773158,1606487,1588456,748,13501,302,14499,18031,1573957,20200806,2020-08-06,2020,8,6,43,10,0.297454344,4.16133805
0.909379024,1613652,1596584,696,13543,303,14519,17068,1582065,20200807,2020-08-07,2020,8,7,20,-23,0.137940548,4.161936705
0.907623929,1620514,1604409,673,13629,304,14562,16105,1589847,20200808,2020-08-08,2020,8,8,43,23,0.296163648,4.163221027
0.907922209,1624650,1607847,629,13642,305,14598,16803,1593249,20200809,2020-08-09,2020,8,9,36,-7,0.247218789,4.164293359
0.907372448,1628303,1611907,651,13658,305,14626,16396,1597281,20200810,2020-08-10,2020,8,10,28,-8,0.191807097,4.165125569
0.904740011,1637844,1620355,663,13729,305,14660,17489,1605695,20200811,2020-08-11,2020,8,11,34,6,0.232462738,4.16613397
0.903099964,1646652,1629277,626,13786,305,14714,17375,1614563,20200812,2020-08-12,2020,8,12,54,20,0.36834925,4.167730752
0.902205119,1654898,1637100,623,13817,305,14770,17798,1622330,20200813,2020-08-13,2020,8,13,56,2,0.380589914,4.169380495
0.904160121,1665084,1644952,648,13863,305,14873,20132,1630079,20200814,2020-08-14,2020,8,14,103,47,0.697359513,4.172398578
0.909427349,1675296,1653678,705,13901,305,15039,21618,1638639,20200815,2020-08-15,2020,8,15,166,63,1.116116453,4.177218959
0.922892283,1681787,1659782,833,13910,305,15318,22005,1644464,20200816,2020-08-16,2020,8,16,279,113,1.855176541,4.185202065
0.931548731,1688470,1665506,1103,13917,305,15515,22964,1649991,20200817,2020-08-17,2020,8,17,197,-82,1.286068677,4.19075178
0.942743341,1697042,1671823,1293,13934,306,15761,25219,1656062,20200818,2020-08-18,2020,8,18,246,49,1.585562359,4.197583769
0.953539164,1715064,1684042,1521,14006,306,16058,31022,1667984,20200819,2020-08-19,2020,8,19,297,51,1.884398198,4.205691454
0.96204722,1734083,1699085,1746,14063,307,16346,34998,1682739,20200820,2020-08-20,2020,8,20,288,-9,1.793498568,4.213411495
0.971401067,1754123,1716078,1976,14120,309,16670,38045,1699408,20200821,2020-08-21,2020,8,21,324,36,1.982136302,4.2219356
0.980862169,1775800,1733373,2241,14169,309,17002,42427,1716371,20200822,2020-08-22,2020,8,22,332,8,1.99160168,4.230500012
0.997808011,1791186,1743622,2524,14200,309,17398,47564,1726224,20200823,2020-08-23,2020,8,23,396,64,2.329137749,4.240499327
1.005678004,1804422,1756427,2889,14219,309,17664,47995,1738763,20200824,2020-08-24,2020,8,24,266,-130,1.528911369,4.247089056
1.010659119,1825837,1775475,3136,14286,310,17944,50362,1757531,20200825,2020-08-25,2020,8,25,280,14,1.585144928,4.253919261
1.016524082,1849506,1796711,3348,14368,312,18264,52795,1778447,20200826,2020-08-26,2020,8,26,320,40,1.783325903,4.261595898
1.029139418,1869579,1817538,3584,14461,313,18705,52041,1798833,20200827,2020-08-27,2020,8,27,441,121,2.414586071,4.271957713
1.038428835,1887717,1837006,3931,14551,316,19076,50711,1817930,20200828,2020-08-28,2020,8,28,371,-70,1.983426891,4.280487314
1.045608675,1909329,1855283,4209,14765,321,19399,54046,1835884,20200829,2020-08-29,2020,8,29,323,-48,1.693227092,4.287779343
1.055542725,1924170,1866149,4313,14903,323,19698,58021,1846451,20200830,2020-08-30,2020,8,30,299,-24,1.541316563,4.294422133
1.061062989,1937689,1879813,4472,14973,324,19946,57876,1859867,20200831,2020-08-31,2020,8,31,248,-51,1.259011067,4.299855815
1.060853045,1959080,1902337,4649,15198,324,20181,56743,1882156,20200901,2020-09-01,2020,9,1,235,-13,1.178181089,4.304942682
1.063036151,1980295,1923547,4659,15356,326,20448,56748,1903099,20200902,2020-09-02,2020,9,2,267,32,1.323026609,4.310650836
1.061321482,2000552,1945028,4766,15529,329,20643,55524,1924385,20200903,2020-09-03,2020,9,3,195,-72,0.953638498,4.314772813
1.059726234,2018906,1966640,4785,15783,331,20841,52266,1945799,20200904,2020-09-04,2020,9,4,198,3,0.959162912,4.318918554
1.058404972,2037045,1984968,4727,16008,333,21009,52077,1963959,20200905,2020-09-05,2020,9,5,168,-30,0.806103354,4.322405381
1.060754971,2045935,1996314,4668,16145,334,21176,49621,1975138,20200906,2020-09-06,2020,9,6,167,-1,0.794897425,4.325843928
1.062525072,2051297,2004188,4697,16296,336,21295,47109,1982893,20200907,2020-09-07,2020,9,7,119,-48,0.561956932,4.328277644
1.059520208,2066078,2022708,4663,16635,341,21431,43370,2001277,20200908,2020-09-08,2020,9,8,136,17,0.63864757,4.331042436
1.0552373,2082234,2045701,4455,17022,344,21587,36533,2024114,20200909,2020-09-09,2020,9,9,156,20,0.727917503,4.334192292
1.052079941,2099591,2066573,4221,17359,346,21742,33018,2044831,20200910,2020-09-10,2020,9,10,155,-1,0.718024737,4.337299491
1.048814521,2119211,2089788,4037,17615,350,21918,29423,2067870,20200911,2020-09-11,2020,9,11,176,21,0.809493147,4.340800923
1.046388101,2135457,2107631,3953,18028,355,22054,27826,2085577,20200912,2020-09-12,2020,9,12,136,-40,0.620494571,4.34348737
1.048183346,2143270,2115565,3671,18225,358,22175,27705,2093390,20200913,2020-09-13,2020,9,13,121,-15,0.548653306,4.345863629
1.049386728,2151002,2123526,3592,18488,363,22284,27476,2101242,20200914,2020-09-14,2020,9,14,109,-12,0.491544532,4.34799315
1.047599084,2164578,2137268,3433,18877,367,22390,27310,2114878,20200915,2020-09-15,2020,9,15,106,-3,0.475677616,4.350054094
1.045197609,2178832,2152990,3146,19309,367,22503,25842,2130487,20200916,2020-09-16,2020,9,16,113,7,0.504689594,4.35224042
1.045797975,2191892,2166384,2827,19542,372,22656,25508,2143728,20200917,2020-09-17,2020,9,17,153,40,0.679909345,4.355183236
1.044584913,2206365,2180962,2742,19770,377,22782,25403,2158180,20200918,2020-09-18,2020,9,18,126,-27,0.556144068,4.357591848
1.043173778,2219162,2194457,2635,19969,378,22892,24705,2171565,20200919,2020-09-19,2020,9,19,110,-16,0.482837328,4.359683737
1.043121974,2226701,2202427,2545,20157,383,22974,24274,2179453,20200920,2020-09-20,2020,9,20,82,-28,0.358203739,4.361236617
1.043161934,2231589,2209053,2434,20247,385,23044,22536,2186009,20200921,2020-09-21,2020,9,21,70,-12,0.304692261,4.362557867
1.039880462,2245112,2221890,2412,20440,388,23105,23222,2198785,20200922,2020-09-22,2020,9,22,61,-9,0.264710988,4.363705973
1.038065223,2256899,2236372,2277,20649,388,23215,20527,2213157,20200923,2020-09-23,2020,9,23,110,49,0.476087427,4.365768688
1.038156014,2268999,2248217,2178,20831,393,23340,20782,2224877,20200924,2020-09-24,2020,9,24,125,15,0.538444971,4.368100852
1.037465813,2280276,2260701,2116,20977,395,23454,19575,2237247,20200925,2020-09-25,2020,9,25,114,-11,0.488431877,4.370216921
1.035065456,2290345,2271837,2082,21165,399,23515,18508,2248322,20200926,2020-09-26,2020,9,26,61,-53,0.260083568,4.371344983
1.036599742,2296517,2277639,1951,21247,401,23610,18878,2254029,20200927,2020-09-27,2020,9,27,95,34,0.403997448,4.373095987
1.036484609,2301303,2282716,1962,21291,406,23660,18587,2259056,20200928,2020-09-28,2020,9,28,50,-45,0.211774672,4.37401474
1.033498649,2313044,2292988,1963,21469,407,23698,20056,2269290,20200929,2020-09-29,2020,9,29,38,-12,0.160608622,4.374711695
1.034180376,2322999,2302403,1822,21590,413,23811,20596,2278592,20200930,2020-09-30,2020,9,30,113,75,0.476833488,4.376777635
1.034826629,2328435,2308406,1808,21665,415,23888,20029,2284518,20201001,2020-10-01,2020,10,1,77,-36,0.32337995,4.37817979
1.035145057,2333777,2313782,1808,21732,416,23951,19995,2289831,20201002,2020-10-02,2020,10,2,63,-14,0.263730743,4.379323651
1.036241273,2339859,2318572,1803,21786,420,24026,21287,2294546,20201003,2020-10-03,2020,10,3,75,12,0.313139326,4.380681473
1.03647274,2346345,2324229,1820,21844,421,24090,22116,2300139,20201004,2020-10-04,2020,10,4,64,-11,0.26637809,4.3818368
1.037069338,2352378,2329931,1825,21885,422,24163,22447,2305768,20201005,2020-10-05,2020,10,5,73,9,0.303030303,4.383150854
1.034619942,2365433,2342696,1856,22082,422,24238,22737,2318458,20201006,2020-10-06,2020,10,6,75,2,0.310391922,4.384496781
1.033644816,2378073,2355935,1734,22333,425,24352,22138,2331583,20201007,2020-10-07,2020,10,7,114,39,0.470335836,4.386534635
1.031350592,2388844,2367866,1594,22462,427,24421,20978,2343445,20201008,2020-10-08,2020,10,8,69,-45,0.283344284,4.387763444
1.028562735,2400233,2379534,1532,22568,428,24475,20699,2355059,20201009,2020-10-09,2020,10,9,54,-15,0.221121166,4.3887227
1.028921466,2404684,2385702,1479,22623,430,24547,18982,2361155,20201010,2020-10-10,2020,10,10,72,18,0.294177732,4.389998423
1.028989871,2410483,2391180,1494,22692,432,24605,19303,2366575,20201011,2020-10-11,2020,10,11,58,-14,0.236281419,4.391023369
1.030830181,2415610,2396418,1481,22728,433,24703,19192,2371715,20201012,2020-10-12,2020,10,12,98,40,0.39829303,4.392749698
1.02983127,2428771,2408647,1542,22863,434,24805,20124,2383842,20201013,2020-10-13,2020,10,13,102,4,0.412905315,4.394539231
1.02672379,2441443,2423047,1508,23030,438,24878,18396,2398169,20201014,2020-10-14,2020,10,14,73,-29,0.294295505,4.395815463
1.027265623,2450739,2432477,1410,23082,439,24988,18262,2407489,20201015,2020-10-15,2020,10,15,110,37,0.44215773,4.397731497
1.025154469,2459426,2442071,1467,23180,441,25035,17355,2417036,20201016,2020-10-16,2020,10,16,47,-63,0.188090283,4.398547596
1.02431086,2468527,2451209,1414,23258,443,25108,17318,2426101,20201017,2020-10-17,2020,10,17,73,26,0.291591772,4.39981212
1.025705526,2474529,2456748,1407,23312,444,25199,17781,2431549,20201018,2020-10-18,2020,10,18,91,18,0.362434284,4.401383307
1.026411361,2479226,2462463,1443,23368,444,25275,16763,2437188,20201019,2020-10-19,2020,10,19,76,-15,0.30159927,4.402691164
1.024825926,2491311,2471932,1463,23466,447,25333,19379,2446599,20201020,2020-10-20,2020,10,20,58,-18,0.229475767,4.403686623
1.0234316,2503489,2483996,1420,23584,450,25422,19493,2458574,20201021,2020-10-21,2020,10,21,89,31,0.351320412,4.405209714
1.02355749,2515325,2495512,1388,23647,453,25543,19813,2469969,20201022,2020-10-22,2020,10,22,121,32,0.475965699,4.407271903
1.024563121,2528621,2508191,1443,23717,455,25698,20430,2482493,20201023,2020-10-23,2020,10,23,155,34,0.606819872,4.409899325
1.023308405,2540679,2518791,1526,23834,457,25775,21888,2493016,20201024,2020-10-24,2020,10,24,77,-78,0.299634213,4.411198674
1.023425171,2546146,2524464,1484,23869,457,25836,21682,2498628,20201025,2020-10-25,2020,10,25,61,-16,0.236663434,4.412225276
1.025281049,2552264,2531501,1510,23905,457,25955,20763,2505546,20201026,2020-10-26,2020,10,26,119,58,0.460597616,4.414221033
1.023467883,2567587,2544584,1593,23981,460,26043,23003,2518541,20201027,2020-10-27,2020,10,27,88,-31,0.339048353,4.415691011
1.021305784,2582960,2560056,1602,24073,461,26146,22904,2533910,20201028,2020-10-28,2020,10,28,103,15,0.39549975,4.417405257
1.021490534,2597978,2571830,1612,24168,462,26271,26148,2545559,20201029,2020-10-29,2020,10,29,125,22,0.478084602,4.419476604
1.020318981,2612231,2585858,1641,24227,463,26384,26373,2559474,20201030,2020-10-30,2020,10,30,113,-12,0.430132085,4.421340638
1.020119177,2624492,2598814,1694,24311,464,26511,25678,2572303,20201031,2020-10-31,2020,10,31,127,14,0.481352335,4.42342611
1.02214605,2630630,2605792,1736,24357,466,26635,24838,2579157,20201101,2020-11-01,2020,11,1,124,-3,0.467730376,4.425452701
1.023772886,2636650,2611126,1812,24395,468,26732,25524,2584394,20201102,2020-11-02,2020,11,2,97,-27,0.364182467,4.427031452
1.021591101,2649859,2624044,1869,24510,472,26807,25815,2597237,20201103,2020-11-03,2020,11,3,75,-22,0.280562622,4.428248214
1.020619749,2662260,2638005,1825,24616,474,26924,24255,2611081,20201104,2020-11-04,2020,11,4,117,42,0.436453165,4.430139582
1.021239933,2673705,2648643,1839,24735,475,27049,25062,2621594,20201105,2020-11-05,2020,11,5,125,8,0.464269796,4.432151214
1.02206801,2686313,2660684,1897,24821,476,27194,25629,2633490,20201106,2020-11-06,2020,11,6,145,20,0.53606418,4.434473093
1.021440784,2697248,2671031,1896,24910,477,27283,26217,2643748,20201107,2020-11-07,2020,11,7,89,-56,0.327278076,4.435892123
1.024416645,2702879,2677231,1980,24968,478,27426,25648,2649805,20201108,2020-11-08,2020,11,8,143,54,0.524135909,4.438162472
1.02675863,2709198,2683396,2043,25029,480,27552,25802,2655844,20201109,2020-11-09,2020,11,9,126,-17,0.45941807,4.44015313
1.025628091,2723959,2696104,2007,25160,485,27652,27855,2668452,20201110,2020-11-10,2020,11,10,100,-26,0.362950058,4.441726548
1.026536241,2736532,2707844,2044,25266,487,27797,28688,2680047,20201111,2020-11-11,2020,11,11,145,45,0.524374367,4.443997927
1.027022378,2749770,2720486,2049,25404,487,27940,29284,2692546,20201112,2020-11-12,2020,11,12,143,-2,0.514444005,4.446226402
1.029952879,2761409,2731290,2106,25537,488,28131,30119,2703159,20201113,2020-11-13,2020,11,13,191,48,0.683607731,4.449185171
1.033182078,2777287,2742595,2208,25636,492,28336,34692,2714259,20201114,2020-11-14,2020,11,14,205,14,0.728733426,4.452338544
1.037775705,2786876,2750498,2360,25691,493,28544,36378,2721954,20201115,2020-11-15,2020,11,15,208,3,0.73404856,4.455514833
1.042482824,2797688,2759374,2513,25759,494,28766,38314,2730608,20201116,2020-11-16,2020,11,16,222,14,0.777746637,4.458879476
1.045069995,2815753,2774551,2642,25860,494,28996,41202,2745555,20201117,2020-11-17,2020,11,17,230,8,0.79955503,4.462338091
1.048880158,2834332,2791644,2812,25973,496,29281,42688,2762363,20201118,2020-11-18,2020,11,18,285,55,0.982894192,4.466585905
1.05424336,2853795,2808270,3010,26098,498,29606,45525,2778664,20201119,2020-11-19,2020,11,19,325,40,1.10993477,4.471379735
1.060229637,2873380,2825237,3190,26263,501,29954,48143,2795283,20201120,2020-11-20,2020,11,20,348,23,1.175437411,4.476454825
1.066305655,2896683,2845338,3472,26365,503,30340,51345,2814998,20201121,2020-11-21,2020,11,21,386,38,1.288642585,4.482015576
1.074331704,2908827,2854798,3699,26466,505,30670,54029,2824128,20201122,2020-11-22,2020,11,22,330,-56,1.087673039,4.486713776
1.079732567,2922072,2865617,3893,26539,509,30941,56455,2834676,20201123,2020-11-23,2020,11,23,271,-59,0.883599609,4.490534346
1.083236082,2946336,2888567,4058,26722,510,31290,57769,2857277,20201124,2020-11-24,2020,11,24,349,78,1.127953201,4.495405563
1.088196409,2966342,2910504,4334,26825,513,31672,55838,2878832,20201125,2020-11-25,2020,11,25,382,33,1.220837328,4.500675489
1.099801168,2987982,2932621,4788,26950,515,32253,55361,2900368,20201126,2020-11-26,2020,11,26,581,199,1.834427886,4.508570117
1.111057679,3009499,2952862,5189,27103,516,32808,56637,2920054,20201127,2020-11-27,2020,11,27,555,-26,1.720770161,4.515979756
1.120395702,3031940,2973146,5440,27349,522,33311,58794,2939835,20201128,2020-11-28,2020,11,28,503,-52,1.533162643,4.52258767
1.131370852,3046908,2984079,5696,27542,523,33761,62829,2950318,20201129,2020-11-29,2020,11,29,450,-53,1.350905106,4.528415302
1.140801353,3061170,2997805,6048,27625,526,34199,63365,2963606,20201130,2020-11-30,2020,11,30,438,-12,1.297354936,4.534013407
1.147691881,3083995,3019103,6239,27885,526,34650,64892,2984453,20201201,2020-12-01,2020,12,1,451,13,1.31875201,4.539703239
1.155922091,3106968,3041814,6570,28065,526,35161,65154,3006653,20201202,2020-12-02,2020,12,2,511,60,1.474747475,4.546061218
1.164379719,3131884,3066096,6820,28352,529,35701,65788,3030395,20201203,2020-12-03,2020,12,3,540,29,1.535792497,4.552680381
1.174407365,3157407,3093390,7182,28611,536,36329,64017,3057061,20201204,2020-12-04,2020,12,4,628,88,1.759054368,4.560253444
1.185080052,3180487,3114220,7449,28917,540,36906,66267,3077314,20201205,2020-12-05,2020,12,5,577,-51,1.58826282,4.567096977
1.200361224,3194858,3127142,7864,29128,545,37537,67716,3089605,20201206,2020-12-06,2020,12,6,631,54,1.709749092,4.57445956
1.214506979,3209367,3141357,8302,29301,549,38152,68010,3103205,20201207,2020-12-07,2020,12,7,615,-16,1.638383462,4.581517309
1.234153658,3221449,3150175,8676,29650,552,38878,71274,3111297,20201208,2020-12-08,2020,12,8,-531,-1788,-1.391801216,4.589703915
1.240004745,3253213,3178133,8676,30177,556,39409,75080,3138724,20201209,2020-12-09,2020,12,9,1257,642,3.233191008,4.595595415
1.250758929,3277938,3205174,8888,30637,564,40089,72764,3165085,20201210,2020-12-10,2020,12,10,1211,1742,3.072902129,4.603025223
1.261103622,3311205,3233517,9049,31157,572,40778,77688,3192739,20201211,2020-12-11,2020,12,11,689,-522,1.718675946,4.610425922
1.278778492,3349856,3263114,9657,31493,578,41728,86742,3221386,20201212,2020-12-12,2020,12,12,950,261,2.329687577,4.62042757
1.301828186,3374585,3284458,10364,31814,580,42758,90127,3241700,20201213,2020-12-13,2020,12,13,1030,80,2.468366564,4.631017383
1.314354263,3397031,3307784,10787,32102,587,43476,89247,3264308,20201214,2020-12-14,2020,12,14,718,-312,1.679217924,4.63824958
1.324953947,3441212,3347739,11197,32559,600,44356,93473,3303383,20201215,2020-12-15,2020,12,15,880,162,2.024105253,4.646952375
1.338665524,3488761,3393977,11875,32947,612,45434,94784,3348543,20201216,2020-12-16,2020,12,16,1078,198,2.430336369,4.657380974
1.35039861,3538835,3439577,12204,33610,634,46448,99258,3393129,20201217,2020-12-17,2020,12,17,1014,-64,2.231808778,4.666967018
1.365611493,3589792,3479174,12885,33982,645,47512,110618,3431662,20201218,2020-12-18,2020,12,18,1064,50,2.290733724,4.676803312
1.379459443,3646235,3520002,13564,34334,659,48557,126233,3471445,20201219,2020-12-19,2020,12,19,1045,-19,2.199444351,4.686251847
1.401227224,3683083,3543608,14258,34722,674,49654,139475,3493954,20201220,2020-12-20,2020,12,20,1097,52,2.259200527,4.69595424
1.417778888,3713849,3567411,14725,35155,698,50578,146438,3516833,20201221,2020-12-21,2020,12,21,924,-173,1.860877271,4.703961652
1.420599914,3772416,3621287,14794,35928,722,51444,151129,3569843,20201222,2020-12-22,2020,12,22,866,-58,1.712206888,4.71133473
1.430100938,3826556,3673447,15069,36726,739,52534,153109,3620913,20201223,2020-12-23,2020,12,23,1090,224,2.118808802,4.72044047
1.434186313,3882196,3731663,15338,37425,756,53519,150533,3678144,20201224,2020-12-24,2020,12,24,985,-105,1.874976206,4.72850799
1.447671509,3939346,3782557,15938,38048,773,54759,156789,3727798,20201225,2020-12-25,2020,12,25,1240,255,2.316934173,4.738455509
1.466009127,3969403,3812391,16565,38532,793,55890,157012,3756501,20201226,2020-12-26,2020,12,26,1131,-109,2.065413905,4.74733411
1.480951309,4006400,3839424,17012,39040,808,56860,166976,3782564,20201227,2020-12-27,2020,12,27,970,-161,1.735551977,4.754806855
1.490687661,4038294,3868416,17579,39268,819,57666,169878,3810750,20201228,2020-12-28,2020,12,28,806,-164,1.417516708,4.760919828
1.494956717,4098166,3927204,17148,40703,859,58710,170962,3868494,20201229,2020-12-29,2020,12,29,1044,238,1.810425554,4.76871208
1.49859394,4159509,3987738,17446,41435,879,59760,171771,3927978,20201230,2020-12-30,2020,12,30,1050,6,1.788451712,4.776410589
1.501831692,4213867,4043529,17557,42270,900,60727,170338,3982802,20201231,2020-12-31,2020,12,31,967,-83,1.618139224,4.783381827
1.509001128,4269303,4092376,17884,42953,917,61754,176927,4030622,20210101,2021-01-01,2021,1,1,1027,60,1.69117526,4.790665093
1.51753665,4302780,4123393,18054,43578,942,62574,179387,4060819,20210102,2021-01-02,2021,1,2,820,-207,1.327849208,4.796393918
1.52204206,4340825,4154353,17762,44507,962,63231,186472,4091122,20210103,2021-01-03,2021,1,3,657,-163,1.049956851,4.80093005
1.534952291,4376595,4185863,18030,45240,981,64251,190732,4121612,20210104,2021-01-04,2021,1,4,1020,363,1.613132799,4.807879891
1.530173855,4439347,4245596,17786,46172,1007,64965,193751,4180631,20210105,2021-01-05,2021,1,5,714,-306,1.111266751,4.812679443
1.525770786,4504853,4312771,17781,46995,1027,65803,192082,4246968,20210106,2021-01-06,2021,1,6,838,124,1.289925344,4.818245694
1.522875336,4569796,4378034,17977,47649,1046,66672,191762,4311362,20210107,2021-01-07,2021,1,7,869,31,1.320608483,4.823943483
1.516958964,4629992,4439540,17896,48369,1081,67346,190452,4372194,20210108,2021-01-08,2021,1,8,674,-195,1.010919126,4.828311806
1.50958738,4689604,4503681,17563,49324,1100,67987,185923,4435694,20210109,2021-01-09,2021,1,9,641,-33,0.951801146,4.832425878
1.51465471,4723444,4531990,17110,50409,1125,68644,191454,4463346,20210110,2021-01-10,2021,1,10,657,16,0.966361216,4.836602583
1.514609144,4751666,4561903,15403,52552,1140,69095,189763,4492808,20210111,2021-01-11,2021,1,11,451,-206,0.657012995,4.839446621
1.504809395,4814067,4627297,14898,53569,1165,69632,186770,4557665,20210112,2021-01-12,2021,1,12,537,86,0.777190824,4.842808869
1.496848095,4872301,4689387,14372,54636,1185,70193,182914,4619194,20210113,2021-01-13,2021,1,13,561,24,0.805664063,4.846293804
1.487023946,4925348,4755606,13750,55772,1195,70717,169742,4684889,20210114,2021-01-14,2021,1,14,524,-37,0.746513185,4.849523828
1.479087326,4978063,4815740,13476,56536,1217,71229,162323,4744511,20210115,2021-01-15,2021,1,15,512,-12,0.724012614,4.852656847
1.4725158,5032259,4876620,13019,57554,1236,71809,155639,4804811,20210116,2021-01-16,2021,1,16,580,68,0.814275085,4.856178879
1.475531703,5061279,4901894,12827,58253,1249,72329,159385,4829565,20210117,2021-01-17,2021,1,17,-42866,-43415,-59.69446727,4.859312461
1.475257315,5087209,4929174,12731,58723,1264,72718,158035,4856456,20210118,2021-01-18,2021,1,18,909,329,1.256757317,4.861641926
1.466194141,5140315,4985970,12353,59468,1283,73104,154345,4912866,20210119,2021-01-19,2021,1,19,386,-523,0.530817679,4.863941141
1.457341804,5192119,5043978,12028,60180,1300,73508,148141,4970470,20210120,2021-01-20,2021,1,20,404,18,0.552637339,4.866334607
1.450163719,5237598,5096528,11746,60846,1316,73908,141070,5022620,20210121,2021-01-21,2021,1,21,400,-4,0.544158459,4.86869145
1.442081737,5282216,5149084,11511,61415,1328,74254,133132,5074830,20210122,2021-01-22,2021,1,22,346,-54,0.468149591,4.870719854
1.438166357,5329700,5193071,11304,62044,1337,74685,136629,5118386,20210123,2021-01-23,2021,1,23,431,85,0.580440111,4.873233385
1.438648888,5354342,5218577,11198,62530,1349,75077,135765,5143500,20210124,2021-01-24,2021,1,24,392,-39,0.524871125,4.87550691
1.440686212,5376079,5241530,11198,62956,1360,75514,134549,5166016,20210125,2021-01-25,2021,1,25,437,45,0.582069076,4.878027476
1.435674359,5422761,5284137,9699,64793,1371,75863,138624,5208274,20210126,2021-01-26,2021,1,26,349,-88,0.462165956,4.880030013
1.433589961,5469240,5330813,9566,65478,1378,76422,138427,5254391,20210127,2021-01-27,2021,1,27,559,210,0.736854593,4.883218399
1.428988634,5522182,5382758,9517,66016,1386,76919,139424,5305839,20210128,2021-01-28,2021,1,28,497,-62,0.650336291,4.886033629
1.426111544,5569257,5426504,9486,66503,1399,77388,142753,5349116,20210129,2021-01-29,2021,1,29,469,-28,0.609732316,4.888673623
1.422918225,5616524,5470729,9309,67121,1414,77844,145795,5392885,20210130,2021-01-30,2021,1,30,456,-13,0.589238642,4.891225144
1.424043977,5640813,5491263,8900,67878,1420,78198,149550,5413065,20210131,2021-01-31,2021,1,31,354,-102,0.454755665,4.893195646
1.424121446,5661837,5512381,8769,68309,1425,78503,149456,5433878,20210201,2021-02-01,2021,2,1,305,-49,0.390035551,4.894886254
1.418696622,5711408,5557143,8629,68775,1435,78839,154265,5478304,20210202,2021-02-02,2021,2,2,336,31,0.428009121,4.896741107
1.411676332,5756709,5617860,8566,69299,1441,79306,138849,5538554,20210203,2021-02-03,2021,2,3,467,131,0.592346428,4.899306046
1.40354193,5803090,5682552,8605,69704,1448,79757,120538,5602795,20210204,2021-02-04,2021,2,4,451,-16,0.568683328,4.90176881
1.396009594,5847174,5739717,8551,70117,1459,80127,107457,5659590,20210205,2021-02-05,2021,2,5,370,-81,0.463909124,4.903778883
1.389261533,5893346,5795669,8548,70505,1464,80517,97677,5715152,20210206,2021-02-06,2021,2,6,390,20,0.48672732,4.905887585
1.388345369,5916967,5826216,8552,70865,1471,80888,90751,5745328,20210207,2021-02-07,2021,2,7,371,-19,0.460772259,4.907884097
1.386830949,5938188,5853345,8484,71218,1474,81176,84843,5772169,20210208,2021-02-08,2021,2,8,288,-83,0.356047869,4.909427647
1.379884866,5987398,5904768,8321,71676,1482,81479,82630,5823289,20210209,2021-02-09,2021,2,9,303,15,0.373263033,4.91104569
1.376871027,6030016,5949940,8211,72226,1486,81923,80076,5868017,20210210,2021-02-10,2021,2,10,444,141,0.544925686,4.913405848
1.376447447,6070001,5988387,8293,72638,1496,82427,81614,5905960,20210211,2021-02-11,2021,2,11,504,60,0.615211845,4.916069494
1.377629709,6093362,6012501,8387,72936,1507,82830,80861,5929671,20210212,2021-02-12,2021,2,12,403,-101,0.488917466,4.918187661
1.37619376,6115330,6045079,8451,73227,1514,83192,70251,5961887,20210213,2021-02-13,2021,2,13,362,-41,0.43703972,4.920081565
1.377757623,6140079,6061879,8437,73559,1522,83518,78200,5978361,20210214,2021-02-14,2021,2,14,326,-36,0.391864602,4.921780086
1.37867916,6162852,6082706,8540,73794,1527,83861,80146,5998845,20210215,2021-02-15,2021,2,15,343,17,0.410689911,4.923560037
1.374021321,6213483,6136586,8233,74551,1534,84318,76897,6052268,20210216,2021-02-16,2021,2,16,457,114,0.544949381,4.925920297
1.372607322,6260560,6188150,8041,75360,1538,84939,72410,6103211,20210217,2021-02-17,2021,2,17,621,164,0.736497545,4.929107144
1.372806714,6303207,6232487,8120,75896,1544,85560,70720,6146927,20210218,2021-02-18,2021,2,18,621,0,0.731112916,4.932270776
1.372474868,6345985,6274869,8058,76513,1550,86121,71116,6188748,20210219,2021-02-19,2021,2,19,561,-60,0.655680224,4.935109064
1.370974179,6390625,6314488,7934,77083,1553,86570,76137,6227918,20210220,2021-02-20,2021,2,20,449,-112,0.521359483,4.937367418
1.37244108,6411333,6337977,7912,77516,1557,86985,73356,6250992,20210221,2021-02-21,2021,2,21,415,-34,0.479380848,4.939444368
1.373626719,6429137,6356676,7868,77887,1562,87317,72461,6269359,20210222,2021-02-22,2021,2,22,332,-83,0.381675001,4.941098806
1.370189069,6472671,6398606,7706,78394,1573,87673,74065,6310933,20210223,2021-02-23,2021,2,23,356,24,0.407709839,4.942865868
1.369066125,6510981,6435993,7487,79050,1576,88113,74988,6347880,20210224,2021-02-24,2021,2,24,440,84,0.501864884,4.945039988
1.365330286,6551206,6482534,7440,79487,1581,88508,68672,6394026,20210225,2021-02-25,2021,2,25,395,-45,0.448287994,4.946982527
1.363190259,6590042,6521100,7430,79880,1585,88895,68942,6432205,20210226,2021-02-26,2021,2,26,387,-8,0.43724861,4.948877334
1.361802856,6627207,6558218,7382,80333,1595,89310,68989,6468908,20210227,2021-02-27,2021,2,27,415,28,0.466842905,4.950900089
1.363496671,6648996,6576107,7365,80697,1603,89665,72889,6486442,20210228,2021-02-28,2021,2,28,355,-60,0.397491882,4.952622953
1.365594246,6665747,6592002,7345,81070,1605,90020,73745,6501982,20210301,2021-03-01,2021,3,1,355,0,0.39591814,4.954339009
1.367382826,6681969,6608537,7420,81338,1606,90364,73432,6518173,20210302,2021-03-02,2021,3,2,344,-11,0.382137303,4.955995447
1.36546628,6716196,6650329,7496,81700,1612,90808,65867,6559521,20210303,2021-03-03,2021,3,3,444,100,0.491346111,4.958124111
1.363339392,6751893,6691804,7451,82162,1619,91232,60089,6600572,20210304,2021-03-04,2021,3,4,424,-20,0.466919214,4.960147196
1.36246771,6789004,6725297,7443,82560,1627,91630,63707,6633667,20210305,2021-03-05,2021,3,5,398,-26,0.436250438,4.962037687
1.362308738,6821936,6756765,7503,82913,1632,92048,65171,6664717,20210306,2021-03-06,2021,3,6,418,20,0.456182473,4.964014357
1.364435288,6843119,6776723,7610,83220,1634,92464,66396,6684259,20210307,2021-03-07,2021,3,7,416,-2,0.451938119,4.965972677
1.365976256,6861802,6794408,7694,83474,1642,92810,67394,6701598,20210308,2021-03-08,2021,3,8,346,-70,0.374199689,4.967594773
1.364893195,6902977,6832476,7711,83900,1645,93256,70501,6739220,20210309,2021-03-09,2021,3,9,446,100,0.480551665,4.969676783
1.36455775,6938877,6868599,7766,84312,1648,93726,70278,6774873,20210310,2021-03-10,2021,3,10,470,24,0.503989019,4.971860083
1.363362007,6976978,6908730,7864,84675,1652,94191,68248,6814539,20210311,2021-03-11,2021,3,11,465,-5,0.496127009,4.974009408
1.363480766,7012657,6943919,7274,85743,1662,94679,68738,6849240,20210312,2021-03-12,2021,3,12,488,23,0.518096209,4.976253662
1.363667431,7046775,6978901,6877,86625,1667,95169,67874,6883732,20210313,2021-03-13,2021,3,13,490,2,0.517538208,4.978495506
1.366787722,7066394,6996551,6551,87408,1669,95628,69843,6900923,20210314,2021-03-14,2021,3,14,459,-31,0.482299909,4.980585073
1.368919801,7084930,7013340,6578,87754,1675,96007,71590,6917333,20210315,2021-03-15,2021,3,15,379,-80,0.396327435,4.982302899
1.36733379,7126067,7048023,6437,88255,1678,96370,78044,6951653,20210316,2021-03-16,2021,3,16,363,-16,0.37809743,4.983941859
1.366231389,7171500,7088038,6339,88814,1686,96839,83462,6991199,20210317,2021-03-17,2021,3,17,469,106,0.486665975,4.986050296
1.364746846,7218077,7128355,6418,89178,1688,97284,89722,7031071,20210318,2021-03-18,2021,3,18,445,-24,0.459525604,4.988041419
1.362025697,7264931,7176590,6534,89523,1690,97747,88341,7078843,20210319,2021-03-19,2021,3,19,463,18,0.475926154,4.990103437
1.360797249,7308935,7215917,6552,89949,1693,98194,93018,7117723,20210320,2021-03-20,2021,3,20,447,-16,0.457303037,4.992084952
1.363625494,7332699,7234391,6626,90328,1696,98650,98308,7135741,20210321,2021-03-21,2021,3,21,456,9,0.464386826,4.99409709
1.365882135,7355954,7252822,6757,90611,1697,99065,103132,7153757,20210322,2021-03-22,2021,3,22,415,-41,0.420679169,4.995920244
1.361643807,7400980,7300808,6628,91079,1704,99411,100172,7201397,20210323,2021-03-23,2021,3,23,346,-69,0.349265634,4.997434442
1.358931149,7441203,7346877,6572,91560,1707,99839,94326,7247038,20210324,2021-03-24,2021,3,24,428,82,0.430535856,4.999300222
1.355193611,7485852,7398869,6492,92068,1709,100269,86983,7298600,20210325,2021-03-25,2021,3,25,430,2,0.430693416,5.001166684
1.352096664,7529391,7451982,6412,92630,1716,100758,77409,7351224,20210326,2021-03-26,2021,3,26,489,59,0.487688119,5.003279538
1.350644798,7572556,7497382,6067,93475,1721,101263,75174,7396119,20210327,2021-03-27,2021,3,27,505,16,0.501200897,5.00545079
1.353535775,7595584,7516979,6168,93855,1722,101745,78605,7415234,20210328,2021-03-28,2021,3,28,482,-23,0.475988268,5.007513076
1.354940491,7616317,7537379,6277,94124,1726,102127,78938,7435252,20210329,2021-03-29,2021,3,29,382,-100,0.375448425,5.009140575
1.352225878,7663991,7585567,6282,94563,1729,102574,78424,7482993,20210330,2021-03-30,2021,3,30,447,65,0.437690327,5.011037292
1.349834806,7707792,7636490,6319,95030,1731,103080,71302,7533410,20210331,2021-03-31,2021,3,31,506,59,0.493302396,5.01317441
1.349601674,7747295,7678636,6457,95439,1735,103631,68659,7575005,20210401,2021-04-01,2021,4,1,551,45,0.534536282,5.015489689
1.350016028,7788290,7717538,6590,95861,1737,104188,70752,7613350,20210402,2021-04-02,2021,4,2,557,6,0.537483958,5.017817701
1.350616973,7829596,7754308,6795,96196,1740,104731,75288,7649577,20210403,2021-04-03,2021,4,3,543,-14,0.521173264,5.02007525
1.354922235,7849470,7769671,6940,96589,1744,105273,79799,7664398,20210404,2021-04-04,2021,4,4,542,-1,0.517516304,5.022316999
1.357764282,7868815,7788318,7099,96900,1748,105747,80497,7682571,20210405,2021-04-05,2021,4,5,474,-68,0.450257901,5.024268055
1.354530128,7921284,7842129,7109,97363,1752,106224,79155,7735905,20210406,2021-04-06,2021,4,6,477,3,0.451076626,5.026222651
1.354517426,7966161,7891519,7208,97928,1756,106892,74642,7784627,20210407,2021-04-07,2021,4,7,668,191,0.628859768,5.028945203
1.35601577,8012415,7934421,7474,98360,1758,107592,77994,7826829,20210408,2021-04-08,2021,4,8,700,32,0.654866594,5.031779981
1.357156244,8059107,7977195,7713,98786,1764,108263,81912,7868932,20210409,2021-04-09,2021,4,9,671,-29,0.623652316,5.034480057
1.358928355,8106625,8016611,7874,99301,1765,108940,90014,7907671,20210410,2021-04-10,2021,4,10,677,6,0.62532906,5.037187371
1.363015759,8129527,8037618,7677,100109,1768,109554,91909,7928064,20210411,2021-04-11,2021,4,11,614,-63,0.563612998,5.039628239
1.366932546,8152778,8057530,7567,100804,1770,110141,95248,7947389,20210412,2021-04-12,2021,4,12,587,-27,0.535808825,5.041949015
1.363942757,8200514,8114930,7576,101332,1775,110683,85584,8004247,20210413,2021-04-13,2021,4,13,542,-45,0.492096494,5.044080922
1.363570274,8245383,8170756,7649,101983,1782,111414,74627,8059342,20210414,2021-04-14,2021,4,14,731,189,0.660444693,5.046939767
1.363743629,8291121,8220900,7811,102513,1788,112112,70221,8108788,20210415,2021-04-15,2021,4,15,698,-33,0.626492182,5.0496521
1.365031284,8333331,8262448,7933,103062,1790,112785,70883,8149663,20210416,2021-04-16,2021,4,16,673,-25,0.600292565,5.052251344
1.365674304,8377778,8306739,8055,103594,1794,113443,71039,8193296,20210417,2021-04-17,2021,4,17,658,-15,0.583410915,5.054777703
1.370923999,8396066,8323875,8311,104006,1797,114114,72191,8209761,20210418,2021-04-18,2021,4,18,671,13,0.591486473,5.057338929
1.373983738,8414821,8344058,8371,104474,1801,114646,70763,8229412,20210419,2021-04-19,2021,4,19,532,-139,0.466200466,5.059358907
1.372676031,8458592,8392002,8166,105227,1802,115195,66590,8276807,20210420,2021-04-20,2021,4,20,549,17,0.478865377,5.061433629
1.375097668,8497594,8430383,8243,105877,1806,115926,67211,8314457,20210421,2021-04-21,2021,4,21,43597,86463,37.84626069,5.064180851
1.377284051,8537505,8470366,8394,106459,1808,116661,67139,8353705,20210422,2021-04-22,2021,4,22,735,-42862,0.634025154,5.066925695
1.37965284,8583530,8513591,8576,107071,1811,117458,69939,8396133,20210423,2021-04-23,2021,4,23,797,62,0.68317604,5.069882602
1.382206691,8632923,8554654,8650,107781,1812,118243,78269,8436411,20210424,2021-04-24,2021,4,24,785,-12,0.668323997,5.07277544
1.386076695,8654791,8577231,8599,108475,1813,118887,77560,8458344,20210425,2021-04-25,2021,4,25,644,-141,0.54464112,5.075134368
1.389034001,8672978,8594894,8719,108850,1817,119386,78084,8475508,20210426,2021-04-26,2021,4,26,499,-145,0.419726295,5.076953402
1.386889523,8721609,8645101,8383,109695,1820,119898,76508,8525203,20210427,2021-04-27,2021,4,27,512,13,0.428861005,5.078811939
1.388669431,8766491,8689325,8597,110248,1821,120666,77166,8568659,20210428,2021-04-28,2021,4,28,768,256,0.640544463,5.081584916
1.390724211,8805774,8725382,8734,110787,1825,121346,80392,8604036,20210429,2021-04-29,2021,4,29,680,-88,0.563539025,5.084025465
1.391855443,8848292,8765781,8757,111422,1828,122007,82511,8643774,20210430,2021-04-30,2021,4,30,661,-19,0.544723353,5.086384748
1.39385709,8883388,8798176,8466,112337,1831,122634,85212,8675542,20210501,2021-05-01,2021,5,1,627,-34,0.51390494,5.088610894
1.398606636,8898234,8811627,8542,112865,1833,123240,86607,8688387,20210502,2021-05-02,2021,5,2,606,-21,0.494153334,5.09075169
1.401809863,8915326,8826304,8538,113356,1834,123728,89022,8702576,20210503,2021-05-03,2021,5,3,488,-118,0.395975333,5.092467993
1.399573986,8957155,8879059,8301,114128,1840,124269,78096,8754790,20210504,2021-05-04,2021,5,4,541,53,0.43724945,5.094362804
1.401502668,8994069,8915074,8154,114944,1847,124945,78995,8790129,20210505,2021-05-05,2021,5,5,676,135,0.543981202,5.096718881
1.404968493,9010992,8933937,8177,115491,1851,125519,77055,8808418,20210506,2021-05-06,2021,5,6,574,-102,0.459402137,5.098709471
1.404787852,9051354,8972458,8162,116022,1860,126044,78896,8846414,20210507,2021-05-07,2021,5,7,525,-49,0.41826337,5.100522177
1.406573167,9089166,9010907,7999,116881,1865,126745,78259,8884162,20210508,2021-05-08,2021,5,8,701,176,0.556154993,5.102930836
1.410705601,9105771,9024491,8012,117423,1874,127309,81280,8897182,20210509,2021-05-09,2021,5,9,564,-137,0.444987968,5.104859107
1.413616464,9122059,9038661,8053,117844,1875,127772,83398,8910889,20210510,2021-05-10,2021,5,10,463,-101,0.363682065,5.106435693
1.412850883,9164284,9079656,7686,118717,1879,128282,84628,8951374,20210511,2021-05-11,2021,5,11,510,47,0.399148483,5.108165722
1.413999381,9201539,9117260,7661,119373,1884,128918,84279,8988342,20210512,2021-05-12,2021,5,12,636,126,0.495782729,5.110313559
1.416191336,9241153,9153636,7836,119906,1891,129633,87517,9024003,20210513,2021-05-13,2021,5,13,715,79,0.554616113,5.112715572
1.419320945,9281291,9186083,8092,120395,1893,130380,95208,9055703,20210514,2021-05-14,2021,5,14,747,32,0.576242161,5.115210977
1.42150471,9319094,9219878,7883,121282,1896,131061,99216,9088817,20210515,2021-05-15,2021,5,15,681,-66,0.522319374,5.117473477
1.425789915,9336614,9234951,8007,121764,1900,131671,101663,9103280,20210516,2021-05-16,2021,5,16,610,-71,0.465432127,5.119490134
1.4299309,9353300,9251496,8224,122163,1903,132290,101804,9119206,20210517,2021-05-17,2021,5,17,619,9,0.47011111,5.121527016
1.429443031,9395004,9291591,8283,122631,1904,132818,103413,9158773,20210518,2021-05-18,2021,5,18,528,-91,0.399123139,5.123256936
1.431454878,9428644,9324150,8322,123237,1912,133471,104494,9190679,20210519,2021-05-19,2021,5,19,653,125,0.491650228,5.125386914
1.43617514,9447358,9338485,8542,123659,1916,134117,108873,9204368,20210520,2021-05-20,2021,5,20,646,-7,0.48400027,5.12748383
1.436877385,9487108,9372964,8598,124158,1922,134678,114144,9238286,20210521,2021-05-21,2021,5,21,561,-85,0.418291492,5.129296658
1.439307962,9520966,9403408,8386,125032,1926,135344,117558,9268064,20210522,2021-05-22,2021,5,22,666,105,0.494512838,5.131439008
1.443892882,9536299,9414064,8117,125881,1931,135929,122235,9278135,20210523,2021-05-23,2021,5,23,585,-81,0.432231942,5.133312122
1.44662691,9553613,9432909,8098,126427,1934,136459,120704,9296450,20210524,2021-05-24,2021,5,24,530,-55,0.389909438,5.135002184
1.445550475,9592727,9475629,8044,126993,1938,136975,117098,9338654,20210525,2021-05-25,2021,5,25,516,-14,0.378135557,5.136641309
1.447922627,9629450,9508381,8160,127574,1940,137674,121069,9370707,20210526,2021-05-26,2021,5,26,699,183,0.510312101,5.138851931
1.449339906,9665693,9543034,8188,128180,1943,138311,122659,9404723,20210527,2021-05-27,2021,5,27,637,-62,0.462687218,5.140856721
1.449937701,9702456,9579584,8193,128759,1946,138898,122872,9440686,20210528,2021-05-28,2021,5,28,587,-50,0.424405868,5.142695992
1.450924946,9733591,9609801,7741,129739,1951,139431,123790,9470370,20210529,2021-05-29,2021,5,29,533,-54,0.383734827,5.144359342
1.45419645,9747614,9621121,7572,130381,1957,139910,126493,9481211,20210530,2021-05-30,2021,5,30,479,-54,0.343539098,5.145848757
1.456836017,9761158,9633205,7558,130823,1959,140340,127953,9492865,20210531,2021-05-31,2021,5,31,430,-49,0.307340433,5.147181472
1.455920354,9798402,9670790,7373,131463,1963,140799,127612,9529991,20210601,2021-06-01,2021,6,1,459,29,0.327062847,5.14859957
1.457699002,9834350,9705433,7443,132068,1965,141476,128917,9563957,20210602,2021-06-02,2021,6,2,677,218,0.480827279,5.150682772
1.459142631,9872324,9742502,7490,132699,1968,142157,129822,9600345,20210603,2021-06-03,2021,6,3,681,4,0.481353728,5.15276825
1.461030859,9911324,9777480,7594,133289,1969,142852,133844,9634628,20210604,2021-06-04,2021,6,4,695,14,0.48889608,5.154886325
1.463952231,9945954,9808790,7862,133763,1971,143596,137164,9665194,20210605,2021-06-05,2021,6,5,744,49,0.520818749,5.157142342
1.467459997,9959697,9823232,7917,134262,1973,144152,136465,9679080,20210606,2021-06-06,2021,6,6,556,-188,0.387197415,5.158820672
1.470520206,9972297,9835771,7802,134861,1974,144637,136526,9691134,20210607,2021-06-07,2021,6,7,485,-71,0.336450413,5.160279405
1.470110969,10008583,9869323,7703,135412,1975,145090,139260,9724233,20210608,2021-06-08,2021,6,8,453,-32,0.313197868,5.161637481
1.469653222,10044783,9913359,7541,136174,1977,145692,131424,9767667,20210609,2021-06-09,2021,6,9,602,149,0.41491488,5.163435705
1.470894135,10076862,9946535,7611,136713,1979,146303,130327,9800232,20210610,2021-06-10,2021,6,10,611,9,0.419377866,5.165253232
1.471909911,10111062,9977309,7652,137224,1981,146857,133753,9830452,20210611,2021-06-11,2021,6,11,554,-57,0.378666193,5.166894652
1.471521964,10140535,10018335,7403,138037,1982,147422,122200,9870913,20210612,2021-06-12,2021,6,12,565,11,0.384728001,5.168562299
1.474553742,10152907,10028390,7308,138581,1985,147874,124517,9880516,20210613,2021-06-13,2021,6,13,452,-113,0.306602814,5.169891821
1.476517846,10165497,10042073,7263,139022,1988,148273,123424,9893800,20210614,2021-06-14,2021,6,14,399,-53,0.26982431,5.171062075
1.475716049,10196469,10072805,6921,139733,1992,148646,123664,9924159,20210615,2021-06-15,2021,6,15,373,-26,0.251562995,5.172153227
1.475587056,10229384,10110620,6760,140438,1993,149191,118764,9961429,20210616,2021-06-16,2021,6,16,545,172,0.366642897,5.173742625
1.477144467,10257836,10136517,6708,141029,1994,149731,121319,9986786,20210617,2021-06-17,2021,6,17,540,-5,0.361952128,5.175311725
1.477526381,10294048,10168211,6426,141816,1996,150238,125837,10017973,20210618,2021-06-18,2021,6,18,507,-33,0.338607236,5.176779794
1.478453976,10323154,10194433,6338,142385,1997,150720,128721,10043713,20210619,2021-06-19,2021,6,19,482,-25,0.320824292,5.178170885
1.48118902,10335634,10204572,6248,142899,2002,151149,131062,10053423,20210620,2021-06-20,2021,6,20,429,-53,0.284633758,5.179405278
1.482792362,10346047,10217614,6234,143268,2004,151506,128433,10066108,20210621,2021-06-21,2021,6,21,357,-72,0.236190779,5.180429832
1.481529887,10380042,10252915,6077,143817,2006,151900,127127,10101015,20210622,2021-06-22,2021,6,22,394,37,0.260055707,5.181557774
1.483877972,10409949,10280158,6159,144379,2007,152545,129791,10127613,20210623,2021-06-23,2021,6,23,645,251,0.424621461,5.183397977
1.484374932,10438782,10317811,6359,144788,2008,153155,120971,10164656,20210624,2021-06-24,2021,6,24,610,-35,0.399882002,5.18513118
1.48669463,10466545,10344357,6391,145389,2009,153789,122188,10190568,20210625,2021-06-25,2021,6,25,634,24,0.413959714,5.186925273
1.487889877,10495516,10380943,6456,145989,2012,154457,114573,10226486,20210626,2021-06-26,2021,6,26,668,34,0.434361365,5.188807595
1.492171802,10508678,10392302,6718,146340,2013,155071,116376,10237231,20210627,2021-06-27,2021,6,27,614,-54,0.39752164,5.190530588
1.495009747,10520929,10406086,6882,146675,2015,155572,114843,10250514,20210628,2021-06-28,2021,6,28,501,-113,0.323077816,5.191931435
1.496012552,10555741,10438883,7073,147077,2017,156167,116858,10282716,20210629,2021-06-29,2021,6,29,595,94,0.382459569,5.193589267
1.499871667,10579072,10464962,7250,147693,2018,156961,114110,10308001,20210630,2021-06-30,2021,6,30,794,199,0.508430078,5.195791757
1.503633528,10614316,10489391,7677,148024,2021,157722,124925,10331669,20210701,2021-07-01,2021,7,1,761,-33,0.484833812,5.197892276
1.508409908,10641602,10510936,8205,148319,2024,158548,130666,10352388,20210702,2021-07-02,2021,7,2,826,65,0.523706268,5.200160768
1.51225601,10670617,10536708,8185,149132,2025,159342,133909,10377366,20210703,2021-07-03,2021,7,3,794,-32,0.500794712,5.202330264
1.517552471,10685125,10548828,8444,149614,2026,160084,136297,10388744,20210704,2021-07-04,2021,7,4,742,-52,0.465665048,5.204347927
1.521924583,10700134,10565241,8723,150044,2028,160795,134893,10404446,20210705,2021-07-05,2021,7,5,711,-31,0.444141826,5.20627254
1.524832365,10735716,10594017,8749,150760,2032,161541,141699,10432476,20210706,2021-07-06,2021,7,6,746,35,0.463944774,5.208282767
1.531972597,10766502,10623754,9220,151500,2033,162753,142748,10461001,20210707,2021-07-07,2021,7,7,1212,466,0.750273924,5.211529003
1.539934192,10802782,10651624,10071,151923,2034,164028,151158,10487596,20210708,2021-07-08,2021,7,8,1275,63,0.783395698,5.21491799
1.547621532,10844217,10683749,10810,152498,2036,165344,160468,10518405,20210709,2021-07-09,2021,7,9,1316,41,0.802302046,5.21838844
1.556415511,10881640,10711921,11531,153153,2038,166722,169719,10545199,20210710,2021-07-10,2021,7,10,1378,62,0.833413973,5.221992911
1.56668484,10902278,10726216,12243,153760,2043,168046,176062,10558170,20210711,2021-07-11,2021,7,11,1324,-54,0.794136347,5.225428179
1.574150085,10919898,10745227,12915,154187,2044,169146,174671,10576081,20210712,2021-07-12,2021,7,12,1100,-224,0.654582674,5.228261732
1.578983139,10964299,10785169,13498,154752,2046,170296,179130,10614873,20210713,2021-07-13,2021,7,13,1150,50,0.679886016,5.231204447
1.587805767,11008859,10826954,14372,155491,2048,171911,181905,10655043,20210714,2021-07-14,2021,7,14,1615,465,0.948348757,5.235303667
1.598299259,11060456,10855977,14952,156509,2050,173511,204479,10682466,20210715,2021-07-15,2021,7,15,1600,-15,0.930714149,5.239327013
1.607343427,11108584,10890392,15882,157113,2051,175046,218192,10715346,20210716,2021-07-16,2021,7,16,1535,-65,0.884670136,5.243152191
1.61606506,11149226,10921590,16485,157960,2055,176500,227636,10745090,20210717,2021-07-17,2021,7,17,1454,-81,0.830638804,5.24674471
